# lvlwidth 21
# lvlheight 26
# bgcolor 0 0 0
# edgecolor 85 0 170
# fillcolor 128 0 255
# pelletcolor 255 255 255

# startleveldata
0 0 0 0 0 0 0 0 0 0 0 0 0 0 0 0 0 0 0 0 0
0 0 0 0 0 0 0 0 0 0 0 0 0 0 0 0 0 0 0 0 0
0 0 0 0 22 0 0 0 0 0 0 0 0 0 0 0 0 0 0 0 0
0 0 0 0 0 0 0 0 0 0 0 0 0 0 0 0 0 0 0 0 0
0 0 0 0 0 0 0 0 0 0 0 0 0 0 0 0 0 0 0 0 0
0 0 0 107 100 100 100 100 100 100 100 100 100 100 100 100 100 108 0 0 0
0 0 0 101 2 2 2 2 2 2 2 2 2 2 2 2 2 101 0 0 0
0 0 0 101 2 0 0 0 0 0 0 0 0 0 0 0 2 101 0 0 0
0 0 0 101 2 0 0 0 0 0 0 0 0 0 0 0 2 101 0 0 0
0 0 0 101 2 0 0 0 0 0 0 0 0 0 0 0 2 101 0 0 0
0 0 0 101 2 0 0 0 0 0 0 0 0 0 0 0 2 101 0 0 0
100 100 100 106 2 0 0 0 0 0 0 0 0 0 0 0 2 105 100 100 100
2 2 2 2 2 0 0 0 0 0 0 0 0 0 0 0 2 2 2 2 2
0 0 0 0 0 0 0 0 0 4 0 0 0 0 0 0 0 0 0 0 0
2 2 2 2 2 0 0 0 0 0 0 0 0 0 0 0 2 2 2 2 2
100 100 100 108 2 0 0 0 0 0 0 0 0 0 0 0 2 107 100 100 100
0 0 0 101 2 0 0 0 0 0 0 0 0 0 0 0 2 101 0 0 0
0 0 0 101 2 0 0 0 0 0 0 0 0 0 0 0 2 101 0 0 0
0 0 0 101 2 0 0 0 0 0 0 0 0 0 0 0 2 101 0 0 0
0 0 0 101 2 0 0 0 0 0 0 0 0 0 0 0 2 101 0 0 0
0 0 0 101 2 2 2 2 2 2 2 2 2 2 2 2 2 101 0 0 0
0 0 0 105 100 100 100 100 100 100 100 100 100 100 100 100 100 106 0 0 0
0 0 0 0 0 0 0 0 0 0 0 0 0 0 0 0 0 0 0 0 0
0 0 0 0 0 0 0 0 0 0 0 0 0 0 0 0 0 0 0 0 0
0 0 0 0 0 0 0 0 0 0 0 0 0 0 0 0 0 0 0 0 0
0 0 0 0 0 0 0 0 0 0 0 0 0 0 0 0 0 0 0 0 0
# endleveldata

# sprites