# lvlwidth 21
# lvlheight 25
# bgcolor 0 0 0
# edgelightcolor 251 233 130
# edgeshadowcolor 124 70 16
# fillcolor 225 151 51
# pelletcolor 255 255 255

# startleveldata
0 0 0 0 0 0 0 0 0 0 0 0 0 0 0 0 0 0 0 0 0
0 107 100 100 100 100 100 133 100 133 100 133 100 133 100 100 100 100 100 108 0
0 101 0 2 0 0 0 101 0 101 0 101 0 101 0 0 0 0 2 101 0
0 101 0 107 100 108 0 101 0 101 2 101 0 101 0 107 100 108 0 101 0
0 101 0 101 0 101 0 110 0 110 0 110 0 110 0 101 0 101 0 101 0
0 101 0 101 0 101 0 2 0 0 0 0 0 0 0 101 0 101 0 101 0 
0 101 0 101 0 131 133 133 133 133 133 133 133 133 133 132 0 101 0 101 0 
0 101 0 131 133 140 140 130 130 130 130 130 130 130 140 140 133 132 0 101 0 
0 101 0 105 130 130 106 0 0 0 0 0 0 0 105 130 130 106 0 101 0
0 101 0 0 0 0 0 0 107 112 0 111 108 0 0 0 0 0 0 101 0
0 105 100 108 0 107 108 0 101 0 0 0 101 0 107 108 0 107 100 106 0
0 0 0 101 0 105 106 2 105 100 100 100 106 0 105 106 0 101 0 0 0 
0 0 0 101 0 0 0 0 0 0 0 2 0 0 2 0 0 101 0 0 0 
0 0 0 101 0 113 2 107 100 100 100 100 100 108 0 113 0 101 0 0 0 
0 0 0 101 0 101 0 110 0 0 4 0 0 110 0 101 0 101 0 0 0
0 107 100 106 0 101 2 0 2 111 133 112 0 0 2 101 0 105 100 108 0
0 101 0 0 0 110 0 113 0 0 101 2 0 113 0 110 0 0 0 101 0 
0 101 0 113 0 2 0 131 108 2 101 0 107 132 0 0 0 113 0 101 0
0 101 2 105 100 108 0 105 106 0 110 0 105 106 0 107 100 106 0 101 0
0 101 0 0 0 101 0 0 0 2 0 0 0 2 0 101 0 0 0 101 0
0 101 0 140 0 101 0 107 100 100 100 100 100 108 0 101 0 140 2 101 0
0 101 2 0 0 110 0 110 0 0 2 0 2 110 0 110 0 0 0 101 0
0 101 0 113 0 2 0 0 0 107 133 108 0 0 0 0 0 113 0 101 0
0 105 100 130 100 100 100 100 100 130 130 130 100 100 100 100 100 130 100 106 0
0 0 0 0 0 0 0 0 0 0 0 0 0 0 0 0 0 0 0 0 0
# endleveldata

# sprites
