# lvlwidth 21
# lvlheight 26
# bgcolor 0 0 0
# edgecolor 85 0 170
# fillcolor 128 0 255
# pelletcolor 255 255 255

# startleveldata
0 0 0 0 0 0 0 0 0 0 0 0 0 0 0 0 0 0 0 0 0
0 0 0 0 0 0 0 0 0 0 0 0 0 0 0 0 0 0 0 0 0
0 107 100 100 100 100 100 100 100 100 100 100 100 100 100 100 100 100 100 108 0
0 101 0 0 2 0 0 0 0 0 0 0 0 0 0 0 0 0 0 101 0
0 101 0 120 0 113 0 111 100 108 0 107 100 112 0 113 0 120 0 101 0
0 101 0 0 0 101 0 0 2 101 0 101 0 0 0 101 0 0 0 101 0 
0 101 2 111 100 106 0 113 0 110 0 110 0 113 0 105 100 112 0 101 0 
0 101 0 0 0 0 0 101 0 0 0 0 0 101 0 0 0 0 0 101 0 
0 101 0 120 0 111 100 130 100 112 0 111 100 130 100 112 0 120 0 101 0 
0 101 0 0 0 0 0 2 0 0 0 0 0 0 0 0 0 0 0 101 0 
0 101 0 113 0 113 0 111 100 100 100 100 100 112 0 113 0 113 0 101 0
0 101 0 101 0 101 0 0 0 0 2 0 0 0 0 101 0 101 0 101 0
0 101 2 101 0 105 112 0 107 112 0 111 108 0 111 106 0 101 0 101 0
0 101 0 101 0 0 0 0 101 0 0 0 101 0 0 0 2 101 2 101 0
0 101 0 110 0 111 112 0 105 100 100 100 106 0 111 112 0 110 0 101 0
0 101 0 0 0 0 0 0 0 0 0 0 0 0 0 0 0 0 0 101 0 
0 101 0 120 0 107 112 0 111 100 100 100 112 0 111 108 0 120 0 101 0 
0 101 0 0 0 101 0 0 0 0 4 0 0 0 0 101 0 0 0 101 0 
0 101 0 113 0 110 0 111 100 100 133 100 100 112 0 110 0 113 0 101 0
0 101 0 101 0 2 0 0 0 0 101 0 2 0 0 0 0 101 0 101 0
0 101 0 101 0 120 0 111 108 2 101 0 107 112 0 120 0 101 0 101 0
0 101 0 101 0 0 0 2 101 0 101 2 101 0 0 0 0 101 0 101 0
0 101 0 105 100 112 0 111 106 0 110 0 105 112 0 111 100 106 0 101 0
0 101 0 0 2 0 0 0 2 2 0 0 0 0 0 0 0 0 0 101 0
0 105 100 100 100 100 100 100 100 100 100 100 100 100 100 100 100 100 100 106 0
0 0 0 0 0 0 0 0 0 0 0 0 0 0 0 0 0 0 0 0 0
# endleveldata

# sprites
