# lvlwidth 21
# lvlheight 25
# bgcolor 0 0 0
# edgecolor 100 50 10
# fillcolor 100 0 0
# pelletcolor 255 255 255

# startleveldata
0 0 0 0 0 0 0 0 0 0 0 0 0 0 0 0 0 0 0 0 0
0 107 100 100 100 100 100 100 100 100 100 100 100 100 100 100 100 100 100 108 0
0 101 0 0 0 0 0 0 0 0 0 0 0 0 0 2 0 0 0 101 0
0 101 0 111 100 108 0 107 100 112 0 111 100 108 0 107 100 112 0 101 0
0 101 0 0 0 101 0 101 0 0 0 0 0 101 0 101 0 0 0 101 0
0 101 0 113 0 101 0 101 0 107 100 108 0 101 0 101 0 113 0 101 0
0 101 0 110 0 110 0 110 0 110 0 110 0 110 0 110 0 110 0 101 0
0 101 0 0 0 0 0 0 0 0 0 0 0 0 0 0 0 0 0 101 0
0 101 0 107 112 0 111 112 0 111 100 112 0 111 112 0 111 108 0 101 0
0 101 0 101 0 0 0 0 0 0 0 0 0 0 0 0 0 101 0 101 0
0 101 0 105 112 0 120 0 107 112 0 111 108 0 120 0 111 106 0 101 0
0 101 0 0 0 0 0 0 101 0 0 0 101 0 0 0 0 0 0 101 0
0 101 0 120 0 111 112 0 105 100 100 100 106 0 111 112 0 120 0 101 0
0 101 0 0 0 0 0 0 0 0 0 0 0 0 0 0 0 0 0 101 0
0 101 0 113 0 120 0 113 0 120 0 120 0 113 0 120 0 113 0 101 0
0 101 0 101 0 0 0 101 0 0 4 0 0 101 0 0 0 101 0 101 0
0 101 0 110 0 111 100 130 100 112 0 111 100 130 100 112 0 110 0 101 0
0 101 0 0 0 0 0 0 0 0 0 0 0 0 0 0 0 0 0 101 0
0 101 0 120 0 120 0 113 0 113 0 113 0 113 0 120 0 120 0 101 0
0 101 0 0 0 0 0 110 0 101 0 101 0 110 0 0 0 0 0 101 0
0 101 0 107 100 108 0 0 0 101 0 101 0 0 0 107 100 108 0 101 0
0 101 0 110 0 110 0 111 100 106 0 105 100 112 0 110 0 110 0 101 0
0 101 0 0 0 0 0 0 0 0 0 0 0 0 0 0 0 0 0 101 0
0 105 100 100 100 100 100 100 100 100 100 100 100 100 100 100 100 100 100 106 0
0 0 0 0 0 0 0 0 0 0 0 0 0 0 0 0 0 0 0 0 0
# endleveldata

# sprites
