# lvlwidth 21
# lvlheight 65
# bgcolor 0 0 0
# edgelightcolor 255 0 128
# edgeshadowcolor 100 0 50
# fillcolor 0 0 0
# pelletcolor 0 0 255
# fruittype 4

# startleveldata
113 21 113 0 0 0 0 0 0 0 0 0 0 0 0 0 0 0 113 21 113 
101 0 105 100 100 100 100 100 100 100 100 100 100 100 100 100 100 100 106 0 101 
101 0 0 0 2 2 2 2 2 0 0 0 2 2 2 2 2 0 0 0 101 
131 100 100 112 3 120 2 113 2 111 100 112 2 113 2 120 3 111 100 100 132 
101 2 2 2 2 2 2 101 2 2 2 2 2 101 2 2 2 2 2 2 101 
101 2 111 108 2 111 100 140 100 112 2 111 100 140 100 112 2 107 112 2 101 
101 2 2 101 2 2 2 101 2 2 2 2 2 101 2 2 2 101 2 2 101 
131 112 2 101 2 113 2 110 2 111 133 112 2 110 2 113 2 101 2 111 132 
101 2 2 101 2 101 2 2 2 2 101 2 2 2 2 101 2 101 2 2 101 
101 2 111 132 2 105 100 100 112 2 110 2 111 100 100 106 2 131 112 2 101 
101 2 2 101 2 2 2 2 2 2 0 2 2 2 2 2 2 101 2 2 101 
105 108 2 110 2 113 2 120 2 111 100 112 2 120 2 113 2 110 2 107 106 
0 101 2 2 2 101 2 2 2 2 2 2 2 2 2 101 2 2 2 101 0 
111 130 100 112 2 105 100 100 100 108 2 107 100 100 100 106 2 111 100 130 112 
20 0 0 0 2 2 2 2 2 101 2 101 2 2 2 2 2 0 0 0 20 
107 100 100 100 100 100 100 112 2 110 2 110 2 111 100 100 100 100 100 100 108 
101 2 2 2 2 2 2 2 2 2 2 2 2 2 2 2 2 2 2 2 101 
101 2 107 108 3 120 0 113 0 111 133 112 0 113 0 120 3 107 108 2 101 
101 2 131 132 2 0 0 101 0 0 101 0 0 101 0 0 2 131 132 2 101 
101 2 131 132 2 111 100 130 112 0 101 0 111 130 100 112 2 131 132 2 101 
101 2 131 132 2 2 2 2 2 2 101 2 2 2 2 2 2 131 132 2 101 
101 2 131 132 2 107 112 2 113 2 110 2 113 2 111 108 2 131 132 2 101 
101 2 131 132 2 110 2 2 101 2 2 2 101 2 2 110 2 131 132 2 101 
101 2 131 132 2 0 2 111 132 0 120 0 131 112 2 0 2 131 132 2 101 
101 2 131 132 2 113 2 2 101 0 0 0 101 2 2 113 2 131 132 2 101 
101 2 131 106 2 105 112 2 110 0 113 0 110 2 111 106 2 105 132 2 101 
110 2 101 0 2 2 2 2 2 2 101 2 2 2 2 2 2 0 101 2 110 
20 2 101 0 111 112 2 107 112 2 101 2 111 108 2 111 112 0 101 2 20 
113 2 101 2 2 2 2 101 2 2 101 2 2 101 2 2 2 2 101 2 113 
101 2 101 2 113 2 111 106 2 111 130 112 2 105 112 2 113 2 101 2 101 
101 2 101 2 101 2 2 2 2 0 0 0 2 2 2 2 101 2 101 2 101 
101 2 101 2 105 100 100 100 112 0 113 0 111 100 100 100 106 2 101 2 101 
101 2 101 2 2 2 2 0 0 0 101 0 0 0 2 2 2 2 101 2 101 
101 2 101 3 111 112 2 111 100 100 130 100 100 112 2 111 112 3 101 2 101 
101 2 101 2 2 2 2 2 0 0 2 0 0 2 2 2 2 2 101 2 101
101 2 131 133 133 133 108 2 107 112 2 111 108 2 107 133 133 133 132 2 101
101 2 105 130 130 130 106 2 101 2 2 2 101 2 105 130 130 130 106 2 101
101 2 2 2 2 2 2 2 105 100 100 100 106 2 2 2 2 2 2 2 101 
131 133 133 133 133 133 108 0 0 0 0 0 0 0 107 133 133 133 133 133 132 
131 140 140 130 130 130 130 100 100 108 2 107 100 100 130 130 130 130 140 140 132 
105 130 132 2 2 2 2 2 2 101 2 101 2 2 2 2 2 2 131 130 106 
20 0 110 2 107 100 100 112 2 110 2 110 2 111 100 100 108 2 110 0 20 
113 2 2 2 101 2 2 2 2 2 2 2 2 2 2 2 101 2 2 2 113 
101 2 111 133 132 2 111 100 100 100 133 100 100 100 112 2 131 133 112 2 101 
101 2 2 131 132 2 2 2 2 2 101 2 2 2 2 2 131 132 2 2 101 
131 108 2 105 106 2 113 2 113 2 101 2 113 2 113 2 105 106 2 107 132 
131 132 2 2 2 2 101 2 110 2 110 2 110 2 101 2 2 2 2 131 132 
131 140 133 133 108 2 101 2 0 2 2 2 0 2 101 2 107 133 133 140 132 
131 140 140 140 132 2 101 2 107 112 2 111 108 2 101 2 131 140 140 140 132 
131 140 140 140 106 2 110 2 110 2 4 2 110 2 110 2 105 140 140 140 132 
105 130 130 106 2 2 2 2 2 2 113 2 2 2 2 2 2 105 130 130 106 
20 0 0 2 2 113 2 111 100 100 140 100 100 112 2 113 2 2 0 0 20 
113 0 113 2 107 132 2 2 2 2 110 2 2 2 2 131 108 2 113 0 113 
101 0 101 2 131 132 3 111 112 2 0 2 111 112 3 131 132 2 101 0 101 
101 0 101 2 105 132 2 0 0 2 113 2 0 0 2 131 106 2 101 0 101 
101 0 101 2 2 101 2 111 112 2 101 2 111 112 2 101 2 2 101 0 101 
101 0 131 108 2 101 2 2 2 2 101 2 2 2 2 101 2 107 132 0 101 
101 0 131 106 2 101 2 111 100 100 130 100 100 112 2 101 2 105 132 0 101 
101 0 101 2 2 101 2 2 2 2 2 2 2 2 2 101 2 2 101 0 101 
101 0 101 2 107 132 2 111 100 108 2 107 100 112 2 131 108 2 101 0 101 
101 0 101 2 131 132 2 2 2 101 2 101 2 2 2 131 132 2 101 0 101 
101 0 101 2 105 130 100 112 2 110 2 110 2 111 100 130 106 2 101 0 101 
101 0 101 2 2 2 2 2 2 2 3 2 2 2 2 2 2 2 101 0 101 
101 0 131 133 133 133 133 133 133 133 133 133 133 133 133 133 133 133 132 0 101 
110 21 105 130 130 130 130 130 130 130 130 130 130 130 130 130 130 130 106 21 110 
# endleveldata

# sprites
