# lvlwidth 21
# lvlheight 65
# bgcolor 0 0 0
# edgelightcolor 255 0 128
# edgeshadowcolor 100 0 50
# fillcolor 0 0 0
# pelletcolor 0 0 255
# fruittype 4

# startleveldata
113 21 113 0 0 0 0 0 0 0 0 0 0 0 0 0 0 0 113 21 113 
101 0 105 100 100 100 100 100 100 100 100 100 100 100 100 100 100 100 106 0 101 
101 0 0 0 ? ? ? ? ? 0 0 0 ? ? ? ? ? 0 0 0 101 
131 100 100 112 ? 120 ? 113 ? 111 100 112 ? 113 ? 120 ? 111 100 100 132
101 ? ? ? ? ? ? 101 ? ? ? ? ? 101 ? ? ? ? ? ? 101 
101 ? 111 108 ? 111 100 140 100 112 ? 111 100 140 100 112 ? 107 112 ? 101 
101 ? ? 101 ? ? ? 101 ? ? ? ? ? 101 ? ? ? 101 ? ? 101 
131 112 ? 101 ? 113 ? 110 ? 111 133 112 ? 110 ? 113 ? 101 ? 111 132 
101 ? ? 101 ? 101 ? ? ? ? 101 ? ? ? ? 101 ? 101 ? ? 101 
101 ? 111 132 ? 105 100 100 112 ? 110 ? 111 100 100 106 ? 131 112 ? 101 
101 ? ? 101 ? ? ? ? ? ? 0 ? ? ? ? ? ? 101 ? ? 101 
105 108 ? 110 ? 113 ? 120 ? 111 100 112 ? 120 ? 113 ? 110 ? 107 106 
0 101 ? ? ? 101 ? ? ? ? ? ? ? ? ? 101 ? ? ? 101 0 
111 130 100 112 ? 105 100 100 100 108 ? 107 100 100 100 106 ? 111 100 130 112 
20 0 0 0 ? ? ? ? ? 101 ? 101 ? ? ? ? ? 0 0 0 20 
107 100 100 100 100 100 100 112 ? 110 ? 110 ? 111 100 100 100 100 100 100 108 
101 ? ? ? ? ? ? ? ? ? ? ? ? ? ? ? ? ? ? ? 101 
101 ? 107 108 ? 120 0 113 0 111 133 112 0 113 0 120 ? 107 108 ? 101
101 ? 131 132 ? 0 0 101 0 0 101 0 0 101 0 0 ? 131 132 ? 101 
101 ? 131 132 ? 111 100 130 112 0 101 0 111 130 100 112 ? 131 132 ? 101 
101 ? 131 132 ? ? ? ? ? ? 101 ? ? ? ? ? ? 131 132 ? 101 
101 ? 131 132 ? 107 112 ? 113 ? 110 ? 113 ? 111 108 ? 131 132 ? 101 
101 ? 131 132 ? 110 ? ? 101 ? ? ? 101 ? ? 110 ? 131 132 ? 101 
101 ? 131 132 ? 0 ? 111 132 0 120 0 131 112 ? 0 ? 131 132 ? 101 
101 ? 131 132 ? 113 ? ? 101 0 0 0 101 ? ? 113 ? 131 132 ? 101 
101 ? 131 106 ? 105 112 ? 110 0 113 0 110 ? 111 106 ? 105 132 ? 101 
110 ? 101 0 ? ? ? ? ? ? 101 ? ? ? ? ? ? 0 101 ? 110 
20 ? 101 0 111 112 ? 107 112 ? 101 ? 111 108 ? 111 112 0 101 ? 20 
113 ? 101 ? ? ? ? 101 ? ? 101 ? ? 101 ? ? ? ? 101 ? 113 
101 ? 101 ? 113 ? 111 106 ? 111 130 112 ? 105 112 ? 113 ? 101 ? 101 
101 ? 101 ? 101 ? ? ? ? 0 0 0 ? ? ? ? 101 ? 101 ? 101 
101 ? 101 ? 105 100 100 100 112 0 113 0 111 100 100 100 106 ? 101 ? 101 
101 ? 101 ? ? ? ? 0 0 0 101 0 0 0 ? ? ? ? 101 ? 101 
101 ? 101 ? 111 112 ? 111 100 100 130 100 100 112 ? 111 112 ? 101 ? 101
101 ? 101 ? ? ? ? ? 0 0 ? 0 0 ? ? ? ? ? 101 ? 101
101 ? 131 133 133 133 108 ? 107 112 ? 111 108 ? 107 133 133 133 132 ? 101
101 ? 105 130 130 130 106 ? 101 ? ? ? 101 ? 105 130 130 130 106 ? 101
101 ? ? ? ? ? ? ? 105 100 100 100 106 ? ? ? ? ? ? ? 101 
131 133 133 133 133 133 108 0 0 0 0 0 0 0 107 133 133 133 133 133 132 
131 140 140 130 130 130 130 100 100 108 ? 107 100 100 130 130 130 130 140 140 132 
105 130 132 ? ? ? ? ? ? 101 ? 101 ? ? ? ? ? ? 131 130 106 
20 0 110 ? 107 100 100 112 ? 110 ? 110 ? 111 100 100 108 ? 110 0 20 
113 ? ? ? 101 ? ? ? ? ? ? ? ? ? ? ? 101 ? ? ? 113 
101 ? 111 133 132 ? 111 100 100 100 133 100 100 100 112 ? 131 133 112 ? 101 
101 ? ? 131 132 ? ? ? ? ? 101 ? ? ? ? ? 131 132 ? ? 101 
131 108 ? 105 106 ? 113 ? 113 ? 101 ? 113 ? 113 ? 105 106 ? 107 132 
131 132 ? ? ? ? 101 ? 110 ? 110 ? 110 ? 101 ? ? ? ? 131 132 
131 140 133 133 108 ? 101 ? 0 ? ? ? 0 ? 101 ? 107 133 133 140 132 
131 140 140 140 132 ? 101 ? 107 112 ? 111 108 ? 101 ? 131 140 140 140 132 
131 140 140 140 106 ? 110 ? 110 ? 4 ? 110 ? 110 ? 105 140 140 140 132 
105 130 130 106 ? ? ? ? ? ? 113 ? ? ? ? ? ? 105 130 130 106 
20 0 0 ? ? 113 ? 111 100 100 140 100 100 112 ? 113 ? ? 0 0 20 
113 0 113 ? 107 132 ? ? ? ? 110 ? ? ? ? 131 108 ? 113 0 113 
101 0 101 ? 131 132 ? 111 112 ? 0 ? 111 112 ? 131 132 ? 101 0 101
101 0 101 ? 105 132 ? 0 0 ? 113 ? 0 0 ? 131 106 ? 101 0 101 
101 0 101 ? ? 101 ? 111 112 ? 101 ? 111 112 ? 101 ? ? 101 0 101 
101 0 131 108 ? 101 ? ? ? ? 101 ? ? ? ? 101 ? 107 132 0 101 
101 0 131 106 ? 101 ? 111 100 100 130 100 100 112 ? 101 ? 105 132 0 101 
101 0 101 ? ? 101 ? ? ? ? ? ? ? ? ? 101 ? ? 101 0 101 
101 0 101 ? 107 132 ? 111 100 108 ? 107 100 112 ? 131 108 ? 101 0 101 
101 0 101 ? 131 132 ? ? ? 101 ? 101 ? ? ? 131 132 ? 101 0 101 
101 0 101 ? 105 130 100 112 ? 110 ? 110 ? 111 100 130 106 ? 101 0 101 
101 0 101 ? ? ? ? ? ? ? ? ? ? ? ? ? ? ? 101 0 101
101 0 131 133 133 133 133 133 133 133 133 133 133 133 133 133 133 133 132 0 101 
110 21 105 130 130 130 130 130 130 130 130 130 130 130 130 130 130 130 106 21 110 
# endleveldata

# sprites
