# lvlwidth 21
# lvlheight 23
# bgcolor 0 0 0
# edgelightcolor 203 211 44
# edgeshadowcolor 0 64 0
# fillcolor 0 0 0
# pelletcolor 255 0 0
# fruittype 1

# startleveldata
113 21 107 100 100 100 100 100 100 100 133 100 100 100 100 100 100 100 108 21 113 
101 0 110 0 0 ? ? ? ? ? 110 ? ? ? ? ? 0 0 110 0 101 
101 0 0 0 113 ? 113 ? 113 ? ? ? 113 ? 113 ? 113 0 0 0 101 
131 100 100 100 106 ? 110 ? 110 ? 113 ? 110 ? 110 ? 105 100 100 100 132
101 ? ? ? ? ? ? ? ? ? 101 ? ? ? ? ? ? ? ? ? 101 
101 ? 107 100 112 ? 113 0 111 100 140 100 112 0 113 ? 111 100 108 ? 101 
101 ? 101 ? ? ? 101 0 0 0 101 0 0 0 101 ? ? ? 101 ? 101 
101 ? 110 ? 111 100 130 100 112 0 110 0 111 100 130 100 112 ? 110 ? 101 
101 ? ? ? 0 0 0 0 0 0 0 0 0 0 0 0 0 ? ? ? 101
101 ? 111 100 100 100 108 0 107 112 0 111 108 0 107 100 100 100 112 ? 101 
101 ? ? ? ? ? 110 0 101 0 0 0 101 0 110 ? ? ? ? ? 101
105 100 100 100 112 ? ? ? 131 100 100 100 132 ? ? ? 111 100 100 100 106 
20 0 0 0 0 0 113 ? 110 0 0 0 110 ? 113 0 0 0 0 0 20 
107 100 100 100 100 100 106 ? 0 0 113 0 0 ? 105 100 100 100 100 100 108 
101 ? ? ? ? ? ? ? 111 100 140 100 112 ? ? ? ? ? ? ? 101 
101 ? 113 ? 107 100 108 0 0 0 101 0 0 0 107 100 108 ? 113 ? 101 
101 ? 101 ? 110 0 105 100 112 0 110 0 111 100 106 0 110 ? 101 ? 101 
101 ? 101 ? ? ? ? ? ? ? 4 ? ? ? ? ? ? ? 101 ? 101 
101 ? 110 ? 120 ? 111 100 108 ? 113 ? 107 100 112 ? 120 ? 110 ? 101 
101 ? ? ? ? ? ? ? 101 ? 101 ? 101 ? ? ? ? ? ? ? 101
101 0 113 ? 111 100 112 ? 110 ? 110 ? 110 ? 111 100 112 ? 113 0 101 
101 0 101 ? ? ? ? ? ? ? ? ? ? ? ? ? ? ? 101 0 101 
110 21 105 100 100 100 100 100 100 100 100 100 100 100 100 100 100 100 106 21 110 
# endleveldata

# sprites
